NO path/north.xpm
EA path/east.xpm
SO path/south.xpm
WE path/west.xpm

C 225,30,0
F 0,0,255

1111111
1000001
1N00111
1000001
1111111