NO path/north.xpm
EA path/east.xpm
SO path/south.xpm
WE path/west.xpm

C 225,30,0
F 0,0,255

11111111111111111111
10000000000011111111
100000000001
10000N01000011111111
110000010000000000001
10000001000000000001
10000001000000000001
11111111111111111111